###########################################
#.......................#..................
#.......................#..................
#...............#..........................
#...........|...........#..................
#...............##......#..................
#.......................#..................
#.......................#..................
#.......................#..................
#..........................................
#.......................#..................
####..###....#...#......#..................
#..........................................
#..........................................
#..........................................
#..........................................
#..........................................
#..........................................