###########################################
#..........................................
#..........................................
#.................................P........
#..........................................
#..........................................
#............#.............................
#...................#......................
#..............#...........@...............
#..........................................
#..........................................
#.............#....#.......................
#..............####........................
#..........................................
#..........................................
#..........................................
#..........................................
#..........................................