###########################################
#..........................................
#..........................................
#.................................P........
#..........................................
#..........................................
#............#.............................
#...................#......................
#..............#..................@........
#..........................................
#..........................................
#.............#++++#.......................
#..............####........................
#..........................................
#..........................................
#..........................................
#..........................................
#..........................................