###########################################
#..........................................
#..........................................
#.................................#........
#...@......................................
#..........................................
#............#.............................
#...................#......................
#..............#........#..................
#..........................................
#..........................................
#.............#....#.......................
#..............####........................
#..........................................
#..........................................
#..........................................
#..........................................
#..........................................